10
P.B.-.-.B.-.-.-.S.G
B.G.S.B.P.B.-.S.W.S
-.BS.W.S.B.-.-.-.S.-
B.P.BS.-.-.G.-.-.-.-
P.B.-.-.-.-.-.-.-.-
B.-.-.-.-.-.B.-.-.-
-.-.G.A.-.B.P.B.-.-
-.-.-.-.-.-.B.G.B.-
-.S.-.-.-.-.-.B.P.B
GS.W.S.-.-.-.-.-.B.G