10
G.-.B.-.B.-.BG.-.B.G
-.B.P.B.P.B.P.B.P.B
G.-.B.-.B.G.B.-.B.B
-.-.S.-.-.-.-.-.B.P
-.S.W.S.G.G.-.-.-.B
-.-.S.-.G.G.-.-.S.-
S.-.-.B.-.-.-.S.W.S
W.S.B.P.B.-.-.-.S.-
S.-.S.B.B.B.G.S.W.S
-.S.W.BS.P.P.B.-.S.A