10
P.B.-.S.W.S.-.-.-.-
B.P.B.-.S.-.-.S.-.S
-.B.-.S.-.S.S.W.S.W
-.B.S.W.S.W.S.S.-.S
B.P.B.S.G.S.-.-.B.-
-.B.S.W.S.W.S.B.P.B
-.B.B.S.-.S.-.B.P.B
B.P.P.B.-.-.-.-.B.-
B.P.P.B.-.-.-.-.-.-
-.B.B.-.-.-.-.-.-.A
